94 95 96 97 98 99 94 95 96 97 98 99 94 95 96 97 98 99 94 95 96 97 98 99 94 95 96 97 98 99 94 95 96 97 98 99 94 95 96 97 98 99 94 95 96 97 98 99 94 95 
105 106 107 94 95 96 105 106 107 94 95 96 105 106 107 94 95 96 105 106 107 94 95 96 105 106 107 94 95 96 105 106 107 94 95 96 105 106 107 94 95 96 105 106 107 94 95 96 105 106 
121 122 123 96 97 98 121 122 123 96 97 98 121 122 123 96 97 98 121 122 123 96 97 98 121 122 123 96 97 98 121 122 123 96 97 98 121 122 123 96 97 98 121 122 123 96 97 98 121 122 
94 95 96 103 104 105 94 95 96 103 104 105 94 95 96 103 104 105 94 95 96 103 104 105 94 95 96 103 104 105 94 95 96 103 104 105 94 95 96 103 104 105 94 95 96 103 104 105 94 95 
124 125 126 96 97 98 124 125 126 96 97 98 124 125 126 96 97 98 124 125 126 96 97 98 124 125 126 96 97 98 124 125 126 96 97 98 124 125 126 96 97 98 124 125 126 96 97 98 124 125 
99 100 101 122 123 124 99 100 101 122 123 124 99 100 101 122 123 124 99 100 101 122 123 124 99 100 101 122 123 124 99 100 101 122 123 124 99 100 101 122 123 124 99 100 101 122 123 124 99 100 
105 106 107 100 101 102 105 106 107 100 101 102 105 106 107 100 101 102 105 106 107 100 101 102 105 106 107 100 101 102 105 106 107 100 101 102 105 106 107 100 101 102 105 106 107 100 101 102 105 106 
94 95 96 97 98 99 94 95 96 97 98 99 94 95 96 97 98 99 94 95 96 97 98 99 94 95 96 97 98 99 94 95 96 97 98 99 94 95 96 97 98 99 94 95 96 97 98 99 94 95 
105 106 107 94 95 96 105 106 107 94 95 96 105 106 107 94 95 96 105 106 107 94 95 96 105 106 107 94 95 96 105 106 107 94 95 96 105 106 107 94 95 96 105 106 107 94 95 96 105 106 
121 122 123 96 97 98 121 122 123 96 97 98 121 122 123 96 97 98 121 122 123 96 97 98 121 122 123 96 97 98 121 122 123 96 97 98 121 122 123 96 97 98 121 122 123 96 97 98 121 122 
94 95 96 103 104 105 94 95 96 103 104 105 94 95 96 103 104 105 94 95 96 103 104 105 94 95 96 103 104 105 94 95 96 103 104 105 94 95 96 103 104 105 94 95 96 103 104 105 94 95 
124 125 126 96 97 98 124 125 126 96 97 98 124 125 126 96 97 98 124 125 126 96 97 98 124 125 126 96 97 98 124 125 126 96 97 98 124 125 126 96 97 98 124 125 126 96 97 98 124 125 
99 100 101 122 123 124 99 100 101 122 123 124 99 100 101 122 123 124 99 100 101 122 123 124 99 100 101 122 123 124 99 100 101 122 123 124 99 100 101 122 123 124 99 100 101 122 123 124 99 100 
105 106 107 100 101 102 105 106 107 100 101 102 105 106 107 100 101 102 105 106 107 100 101 102 105 106 107 100 101 102 105 106 107 100 101 102 105 106 107 100 101 102 105 106 107 100 101 102 105 106 
94 95 96 97 98 99 94 95 96 97 98 99 94 95 96 97 98 99 94 95 96 97 98 99 94 95 96 97 98 99 94 95 96 97 98 99 94 95 96 97 98 99 94 95 96 97 98 99 94 95 
105 106 107 94 95 96 105 106 107 94 95 96 105 106 107 94 95 96 105 106 107 94 95 96 105 106 107 94 95 96 105 106 107 94 95 96 105 106 107 94 95 96 105 106 107 94 95 96 105 106 
121 122 123 96 97 98 121 122 123 96 97 98 121 122 123 96 97 98 121 122 123 96 97 98 121 122 123 96 97 98 121 122 123 96 97 98 121 122 123 96 97 98 121 122 123 96 97 98 121 122 
94 95 96 103 104 105 94 95 96 103 104 105 94 95 96 103 104 105 94 95 96 103 104 105 94 95 96 103 104 105 94 95 96 103 104 105 94 95 96 103 104 105 94 95 96 103 104 105 94 95 
124 125 126 96 97 98 124 125 126 96 97 98 124 125 126 96 97 98 124 125 126 96 97 98 124 125 126 96 97 98 124 125 126 96 97 98 124 125 126 96 97 98 124 125 126 96 97 98 124 125 
99 100 101 122 123 124 99 100 101 122 123 124 99 100 101 122 123 124 99 100 101 122 123 124 99 100 101 122 123 124 99 100 101 122 123 124 99 100 101 122 123 124 99 100 101 122 123 124 99 100 
105 106 107 100 101 102 105 106 107 100 101 102 105 106 107 100 101 102 105 106 107 100 101 102 105 106 107 100 101 102 105 106 107 100 101 102 105 106 107 100 101 102 105 106 107 100 101 102 105 106 
94 95 96 97 98 99 94 95 96 97 98 99 94 95 96 97 98 99 94 95 96 97 98 99 94 95 96 97 98 99 94 95 96 97 98 99 94 95 96 97 98 99 94 95 96 97 98 99 94 95 
105 106 107 94 95 96 105 106 107 94 95 96 105 106 107 94 95 96 105 106 107 94 95 96 105 106 107 94 95 96 105 106 107 94 95 96 105 106 107 94 95 96 105 106 107 94 95 96 105 106 
121 122 123 96 97 98 121 122 123 96 97 98 121 122 123 96 97 98 121 122 123 96 97 98 121 122 123 96 97 98 121 122 123 96 97 98 121 122 123 96 97 98 121 122 123 96 97 98 121 122 
94 95 96 103 104 105 94 95 96 103 104 105 94 95 96 103 104 105 94 95 96 103 104 105 94 95 96 103 104 105 94 95 96 103 104 105 94 95 96 103 104 105 94 95 96 103 104 105 94 95 
124 125 126 96 97 98 124 125 126 96 97 98 124 125 126 96 97 98 124 125 126 96 97 98 124 125 126 96 97 98 124 125 126 96 97 98 124 125 126 96 97 98 124 125 126 96 97 98 124 125 
99 100 101 122 123 124 99 100 101 122 123 124 99 100 101 122 123 124 99 100 101 122 123 124 99 100 101 122 123 124 99 100 101 122 123 124 99 100 101 122 123 124 99 100 101 122 123 124 99 100 
105 106 107 100 101 102 105 106 107 100 101 102 105 106 107 100 101 102 105 106 107 100 101 102 105 106 107 100 101 102 105 106 107 100 101 102 105 106 107 100 101 102 105 106 107 100 101 102 105 106 
94 95 96 97 98 99 94 95 96 97 98 99 94 95 96 97 98 99 94 95 96 97 98 99 94 95 96 97 98 99 94 95 96 97 98 99 94 95 96 97 98 99 94 95 96 97 98 99 94 95 
105 106 107 94 95 96 105 106 107 94 95 96 105 106 107 94 95 96 105 106 107 94 95 96 105 106 107 94 95 96 105 106 107 94 95 96 105 106 107 94 95 96 105 106 107 94 95 96 105 106 
121 122 123 96 97 98 121 122 123 96 97 98 121 122 123 96 97 98 121 122 123 96 97 98 121 122 123 96 97 98 121 122 123 96 97 98 121 122 123 96 97 98 121 122 123 96 97 98 121 122 
94 95 96 103 104 105 94 95 96 103 104 105 94 95 96 103 104 105 94 95 96 103 104 105 94 95 96 103 104 105 94 95 96 103 104 105 94 95 96 103 104 105 94 95 96 103 104 105 94 95 
124 125 126 96 97 98 124 125 126 96 97 98 124 125 126 96 97 98 124 125 126 96 97 98 124 125 126 96 97 98 124 125 126 96 97 98 124 125 126 96 97 98 124 125 126 96 97 98 124 125 
99 100 101 122 123 124 99 100 101 122 123 124 99 100 101 122 123 124 99 100 101 122 123 124 99 100 101 122 123 124 99 100 101 122 123 124 99 100 101 122 123 124 99 100 101 122 123 124 99 100 
105 106 107 100 101 102 105 106 107 100 101 102 105 106 107 100 101 102 105 106 107 100 101 102 105 106 107 100 101 102 105 106 107 100 101 102 105 106 107 100 101 102 105 106 107 100 101 102 105 106 
94 95 96 97 98 99 94 95 96 97 98 99 94 95 96 97 98 99 94 95 96 97 98 99 94 95 96 97 98 99 94 95 96 97 98 99 94 95 96 97 98 99 94 95 96 97 98 99 94 95 
105 106 107 94 95 96 105 106 107 94 95 96 105 106 107 94 95 96 105 106 107 94 95 96 105 106 107 94 95 96 105 106 107 94 95 96 105 106 107 94 95 96 105 106 107 94 95 96 105 106 
121 122 123 96 97 98 121 122 123 96 97 98 121 122 123 96 97 98 121 122 123 96 97 98 121 122 123 96 97 98 121 122 123 96 97 98 121 122 123 96 97 98 121 122 123 96 97 98 121 122 
94 95 96 103 104 105 94 95 96 103 104 105 94 95 96 103 104 105 94 95 96 103 104 105 94 95 96 103 104 105 94 95 96 103 104 105 94 95 96 103 104 105 94 95 96 103 104 105 94 95 
124 125 126 96 97 98 124 125 126 96 97 98 124 125 126 96 97 98 124 125 126 96 97 98 124 125 126 96 97 98 124 125 126 96 97 98 124 125 126 96 97 98 124 125 126 96 97 98 124 125 
99 100 101 122 123 124 99 100 101 122 123 124 99 100 101 122 123 124 99 100 101 122 123 124 99 100 101 122 123 124 99 100 101 122 123 124 99 100 101 122 123 124 99 100 101 122 123 124 99 100 
105 106 107 100 101 102 105 106 107 100 101 102 105 106 107 100 101 102 105 106 107 100 101 102 105 106 107 100 101 102 105 106 107 100 101 102 105 106 107 100 101 102 105 106 107 100 101 102 105 106 
94 95 96 97 98 99 94 95 96 97 98 99 94 95 96 97 98 99 94 95 96 97 98 99 94 95 96 97 98 99 94 95 96 97 98 99 94 95 96 97 98 99 94 95 96 97 98 99 94 95 
105 106 107 94 95 96 105 106 107 94 95 96 105 106 107 94 95 96 105 106 107 94 95 96 105 106 107 94 95 96 105 106 107 94 95 96 105 106 107 94 95 96 105 106 107 94 95 96 105 106 
121 122 123 96 97 98 121 122 123 96 97 98 121 122 123 96 97 98 121 122 123 96 97 98 121 122 123 96 97 98 121 122 123 96 97 98 121 122 123 96 97 98 121 122 123 96 97 98 121 122 
94 95 96 103 104 105 94 95 96 103 104 105 94 95 96 103 104 105 94 95 96 103 104 105 94 95 96 103 104 105 94 95 96 103 104 105 94 95 96 103 104 105 94 95 96 103 104 105 94 95 
124 125 126 96 97 98 124 125 126 96 97 98 124 125 126 96 97 98 124 125 126 96 97 98 124 125 126 96 97 98 124 125 126 96 97 98 124 125 126 96 97 98 124 125 126 96 97 98 124 125 
99 100 101 122 123 124 99 100 101 122 123 124 99 100 101 122 123 124 99 100 101 122 123 124 99 100 101 122 123 124 99 100 101 122 123 124 99 100 101 122 123 124 99 100 101 122 123 124 99 100 
105 106 107 100 101 102 105 106 107 100 101 102 105 106 107 100 101 102 105 106 107 100 101 102 105 106 107 100 101 102 105 106 107 100 101 102 105 106 107 100 101 102 105 106 107 100 101 102 105 106 
94 95 96 97 98 99 94 95 96 97 98 99 94 95 96 97 98 99 94 95 96 97 98 99 94 95 96 97 98 99 94 95 96 97 98 99 94 95 96 97 98 99 94 95 96 97 98 99 94 95 
105 106 107 94 95 96 105 106 107 94 95 96 105 106 107 94 95 96 105 106 107 94 95 96 105 106 107 94 95 96 105 106 107 94 95 96 105 106 107 94 95 96 105 106 107 94 95 96 105 106 
121 122 123 96 97 98 121 122 123 96 97 98 121 122 123 96 97 98 121 122 123 96 97 98 121 122 123 96 97 98 121 122 123 96 97 98 121 122 123 96 97 98 121 122 123 96 97 98 121 122 
94 95 96 103 104 105 94 95 96 103 104 105 94 95 96 103 104 105 94 95 96 103 104 105 94 95 96 103 104 105 94 95 96 103 104 105 94 95 96 103 104 105 94 95 96 103 104 105 94 95 
124 125 126 96 97 98 124 125 126 96 97 98 124 125 126 96 97 98 124 125 126 96 97 98 124 125 126 96 97 98 124 125 126 96 97 98 124 125 126 96 97 98 124 125 126 96 97 98 124 125 
99 100 101 122 123 124 99 100 101 122 123 124 99 100 101 122 123 124 99 100 101 122 123 124 99 100 101 122 123 124 99 100 101 122 123 124 99 100 101 122 123 124 99 100 101 122 123 124 99 100